{
  "enemies": [
    {
      "type": "Dino",
      "x": 6,
      "y": 1
    },
    {
      "type": "Dino",
      "x": 10,
      "y": 3
    }
  ],
  "collectables": [],
  "mapHeight": 8,
  "mapWidth": 13,
  "tileMap": [
    [2, 2, 2, 2, 2, 2, 2, 2, 2, 2, 2, 2, 2],
    [2, 6, 2, 0, 2, 6, 0, 0, 2, 6, 2, 0, 2],
    [2, 0, 6, 0, 0, 0, 0, 6, 0, 0, 6, 0, 2],
    [2, 0, 2, 0, 2, 6, 2, 0, 2, 0, 2, 6, 2],
    [2, 0, 0, 6, 0, 0, 6, 0, 0, 0, 6, 0, 2],
    [2, 6, 2, 0, 2, 0, 2, 0, 2, 0, 2, 6, 2],
    [2, 0, 6, 0, 0, 6, 0, 0, 0, 0, 6, 0, 2],
    [2, 2, 2, 2, 2, 2, 2, 2, 2, 2, 2, 2, 2]
  ]
}
